A blessing in disguise	as part of a sentence
A dime a dozen	as part of a sentence
Beat around the bush	as part of a sentence
Better late than never	by itself
Bite the bullet	as part of a sentence
Break a leg	by itself
Call it a day	as part of a sentence
Cut somebody some slack	as part of a sentence
Cutting corners	as part of a sentence
Easy does it	by itself
Get out of hand	as part of a sentence
Get something out of your system	as part of a sentence
Get your act together	by itself
Give someone the benefit of the doubt	as part of a sentence
Go back to the drawing board	as part of a sentence
Hang in there	by itself
Hit the sack	as part of a sentence
It's not rocket science	by itself
Let someone off the hook	as part of a sentence
Make a long story short	as part of a sentence
Miss the boat	as part of a sentence
No pain, no gain	by itself
On the ball	as part of a sentence
Pull someone's leg	as part of a sentence
Pull yourself together	by itself
So far so good	by itself
Speak of the devil	by itself
That's the last straw	by itself
The best of both worlds	as part of a sentence
Time flies when you're having fun	by itself
To get bent out of shape	as part of a sentence
To make matters worse	as part of a sentence
Under the weather	as part of a sentence
We'll cross that bridge when we come to it	by itself
Wrap your head around something	as part of a sentence
You can say that again	by itself
Your guess is as good as mine	by itself
A bird in the hand is worth two in the bush	by itself
A penny for your thoughts	by itself
A penny saved is a penny earned	by itself
A perfect storm	as part of a sentence
A picture is worth 1000 words	by itself
Actions speak louder than words	by itself
Add insult to injury	as part of a sentence
Barking up the wrong tree	as part of a sentence
Birds of a feather flock together	by itself
Bite off more than you can chew	as part of a sentence
Break the ice	as part of a sentence
By the skin of your teeth	as part of a sentence
Comparing apples to oranges	as part of a sentence
Costs an arm and a leg	as part of a sentence
Do something at the drop of a hat	as part of a sentence
Do unto others as you would have them do unto you	by itself
Don't count your chickens before they hatch	by itself
Don't cry over spilt milk	by itself
Don't give up your day job	by itself
Don't put all your eggs in one basket	by itself
Every cloud has a silver lining	by itself
Get a taste of your own medicine	as part of a sentence
Give someone the cold shoulder	as part of a sentence
Go on a wild goose chase	as part of a sentence
Good things come to those who wait	by itself
He has bigger fish to fry	by itself
He's a chip off the old block	by itself
Hit the nail on the head	by itself
Ignorance is bliss	by itself
It ain't over till the fat lady sings	by itself
It takes one to know one	by itself
It's a piece of cake	by itself
It's raining cats and dogs	by itself
Kill two birds with one stone	by itself
Let the cat out of the bag	as part of a sentence
Live and learn	by itself
Look before you leap	by itself
On thin ice	as part of a sentence
Once in a blue moon	as part of a sentence
Play devil's advocate	as part of a sentence
Put something on ice	as part of a sentence
Rain on someone's parade	as part of a sentence
Saving for a rainy day	as part of a sentence
Slow and steady wins the race	by itself
Spill the beans	as part of a sentence
Take a rain check	as part of a sentence
Take it with a grain of salt	as part of a sentence
The ball is in your court	by itself
The best thing since sliced bread	as part of a sentence
The devil is in the details	by itself
The early bird gets the worm	by itself
The elephant in the room	as part of a sentence
The whole nine yards	as part of a sentence
There are other fish in the sea	by itself
There's a method to his madness	by itself
There's no such thing as a free lunch	by itself
Throw caution to the wind	as part of a sentence
You can't have your cake and eat it too	by itself
You can't judge a book by its cover	by itself
A little learning is a dangerous thing	by itself
A snowball effect	as part of a sentence
A snowball's chance in hell	as part of a sentence
A stitch in time saves nine	by itself
A storm in a teacup	as part of a sentence
An apple a day keeps the doctor away	by itself
An ounce of prevention is worth a pound of cure	by itself
As right as rain	as part of a sentence
Bolt from the blue	as part of a sentence
Burn bridges	as part of a sentence
Calm before the storm	as part of a sentence
Come rain or shine	as part of a sentence
Curiosity killed the cat	by itself
Cut the mustard	as part of a sentence
Don't beat a dead horse	by itself
Every dog has his day	by itself
Familiarity breeds contempt	by itself
Fit as a fiddle	as part of a sentence
Fortune favours the bold	by itself
Get a second wind	as part of a sentence
Get wind of something	as part of a sentence
Go down in flames	as part of a sentence
Haste makes waste	by itself
Have your head in the clouds	as part of a sentence
He who laughs last laughs loudest	by itself
Hear something straight from the horse's mouth	as part of a sentence
He's not playing with a full deck	by itself
He's off his rocker	by itself
He's sitting on the fence	by itself
It is a poor workman who blames his tools	by itself
It is always darkest before the dawn	by itself
It takes two to tango	by itself
Jump on the bandwagon	as part of a sentence
Know which way the wind is blowing	as part of a sentence
Leave no stone unturned	as part of a sentence
Let sleeping dogs lie	as part of a sentence
Like riding a bicycle	as part of a sentence
Like two peas in a pod	as part of a sentence
Make hay while the sun shines	as part of a sentence
On cloud nine	as part of a sentence
Once bitten, twice shy	by itself
Out of the frying pan and into the fire	by itself
Run like the wind	as part of a sentence
Shape up or ship out	by itself
Snowed under	as part of a sentence
That ship has sailed	by itself
The pot calling the kettle black	as part of a sentence
There are clouds on the horizon	by itself
Those who live in glass houses shouldn't throw stones	by itself
Through thick and thin	as part of a sentence
Time is money	by itself
Waste not, want not	by itself
We see eye to eye	by itself
Weather the storm	as part of a sentence
Well begun is half done	by itself
When it rains it pours	by itself
You can catch more flies with honey than you can with vinegar	by itself
You can lead a horse to water, but you can't make him drink	by itself
You can't make an omelet without breaking some eggs	by itself
